Ones illions:
K - Thousand
M - Million
B - Billion
T - Trillion
Q - Quadrillion
Qi - Quintillion
Sx - Sextillion
Sp - Septillion
Oc - Octillion
N - Nonillion

Tens illions:
De - Decillion
--After Decillion: UDe DDe TDe QDe QiDe SxDe SpDe OcDe NDe--
V - Vigintillion
TR - Trigintillion
QU - Quadragintillion
QI - Quinquagintillion
SX - Sexagintillion
SP - Septuagintillion
OC - Octogintillion
NO - Nonagintillion

Prefixes in Decillions:
U - Un-
D - Duo-
T - Tre-
Q - Quattuor-
Qi - Quin-
Sx - Sex-
Sp - Septen-
Oc - Octo-
N - Novem-

Hundreds illions:
CE - Centillion
DU - Ducentillion
TE - Trucentillion
QR - Quadringentillion
QN - Quingentillion
SE - Sescentillion
ST - Septingentillion
OT - Octingentillion
NN - Nongentillion

Larger numbers:
Mil - Millillion
MilM - Milli-million
BMil - Bilmillillion
DeMil - Decimillillion
(My - Myrillion)
CEMil - Centimillillion
Mic - Micrillion
Na - Nanillion
Pi - Picillion
Fm - Femtillion
At - Attillion
Zp - Zeptillion
Yc - Yoctillion
Xn - Xonillion
Vc - Vecillion
Mc - Mecillion
Due - Duecillion
Tre - Trecillion
Tte - Tetrecillion
Pn - Pentecillion
Hx - Hexecillion
Hp - Heptecillion
Oct - Octecillion
En - Ennecillion
Ico - Icosillion
Mco - Meicosillion
Di - Dueicosillion
Tc - Triacontillion
Ttc - Tetracontillion
Pc - Pentacontillion
Hxc - Hexacontillion
Hpc - Heptacontillion
Occ - Octacontillion
Ec - Ennecontillion
Hc - Hectillion
Dh - Dohectillion
Th - Triahectillion
Tth - Tetrahectillion
Ph - Pentahectillion
Hh - Hexahectillion
Hph - Heptahectillion
Och - Octahectillion
Eh - Ennahectillion
Ki - Killillion
Mg - Megillion
Gi - Gigillion
Ter - Terillion
Pt - Petillion
Ex - Exillion
Zt - Zettillion
Yt - Yottillion
Xe - Xennillion
Dk - Dakillion
Hd - Hendillion
Do - Dokillion
Tra - Tradakillion
Ted - Tedakillion
Pd - Pedakillion
Ed - Exdakillion
Zd - Zedakillion
Yd - Yodakillion
Nd - Nedakillion
Ik - Ikillion
Ikn - Ikenillion
Id - Icodillion
It - Ictrillion
Itr - Icterillion
Icp - Icpetillion
Ikc - Ikectillion
Iz - Iczetillion
Iy - Ikyotillion
Ix - Icxenillion
Tk - Trakillion
Tek - Tekillion
Pk - Pekillion
Ek - Exakillion
Zk - Zakillion
Yk - Yokillion
Nk - Nekillion
Ht - Hotillion
Bt - Botillion
Tt - Trotillion
Tot - Totillion
Pt - Potillion
Exo - Exotillion
Zo - Zotillion
Yo - Yootillion
No - Notillion
Ka - Kalillion
Da - Dalillion
Tra - Tralillion
Ta - Talillion 
Pa - Palillion
Ea - Exalillion
Za - Zalillion
Ya - Yalillion
NA - Nalillion
Dak - Dakalillion
Ha - Hendalillion
Dka - Dokalillion
Tad - Tradakalillion
Tdk - Tedakalillion
Pdk - Pedakalillion
Edk - Exdakalillion
Zdk - Zedakalillion
Ydk - Yodakalillion
Ndk - Nedakalillion
Ika - Ikalillion
Tka - Trakalillion
Tea - Tekalillion
Pka - Pekalillion
Eka - Exakalillion
Zka - Zakalillion
Yka - Yokalillion
Nka - Nekalillion
Hot - Hotalillion
Bta - Botalillion
Tta - Trotalillion
Toa - Totalillion
Pta - Potalillion
Eta - Exotalillion
Zta - Zotalillion
Yta - Yootalillion
Nta - Notalillion
Mj - Mejillion
Bj/Dj - Bejillion/Dejillion
Tj - Trejillion
Tej - Tejillion
Pj - Pejillion
Ej - Exejillion
Zj - Zejillion
Yj - Yejillion
Nj - Nejillion
Dkj - Dakejillion
Hj - Hendejillion
Doj - Dokejillion
Tkj - Tradakejillion
Tdj - Tedakejillion
Pkj - Pedakejillion
Ekj - Exdakejillion
Zkj - Zedakejillion
Ykj - Yodakejillion
Nkj - Nedakejillion
Ij - Ikejillion
Htj - Hotejillion
Gj - Gijillion
Dij - Dijillion
Trj - Trijillion
Tij - Tijillion
Pij - Pijillion
Eij - Exijillion
Zij - Zijillion
Yij - Yijillion
Nij - Nijillion
Dij - Dakijillion
Hij - Hotijillion
Ast - Astillion
Ln - Lunillion
Fr - Fermillion
Jv - Jovillion
Sl - Solillion
Bt - Betillion
Glc - Glocillion
Gx - Gaxillion
Sup - Supillion
Vs - Versillion
Mlt - Multillion

Special abbreviations that I made up based on anime & manga characters (these are NOT real numbers and have NO SPECIFIC VALUE):
Mk - Mikuillion (Hatsune Miku)
Ri - Rinillion (Kagamine Rin)
Le - Lenillion (Kagamine Len)
Lk - Lukaillion (Megurine Luka)
Me - Meikillion (MEIKO)
Kt - Kaitillion (KAITO)
Yi - Yujillion (Yuji Itadori)
Mm - Megumillion (Megumi Fushiguro)
Goj - Gojillion (Satoru Gojo)
Nb - Nobaraillion (Nobara Kugisaki)
Ge - Getillion (Suguru Geto)
Z'n - Zen'inillion (Maki Zen'in)
Mh - Mahitillion (Mahito)
Suk - Sukunaillion (Ryomen Sukuna)
Toj - Tojillion (Toji Fushiguro)
Yta - Yutaillion (Yuta Okkotsu)
To - Togeillion (Toge Inumaki)
Lf - Luffyillion (Monkey D. Luffy)
Gku - Gokuillion (Goku)
Nr - Narutillion (Naruto Uzumaki)
Kk - Kakashillion (Kakashi Hatake)
Sa - Sakuraillion (Sakura Haruno)
An - Anyaillion (Anya Forger)
Lod - Loidillion (Loid Forger)
Yor - Yorillion (Yor Forger)
Dm - Damianillion (Damian Desmond)
